11111111
10100001
10100001
10000101
11100001
10000001
10001001
11111111