11111111111111111111111111
10000000000000000000000001
10000010000000011001000001
10011110000000010000000001
10000010000010010110000001
10000000000010000000000001
10001110000010011011100001
10000011100010000000000001
10000000000000000010100001
10000111100000000011100001
10000000000000000000000001
10000010000000000000111111
10000011000001000000000001
10111000000001000000000001
10001000000001000000110001
10001000000000000000110001
10000000000020000000000001
11111111111111111111111111