11111111111111111111111111
10030000000000000000000001
10001000100000000111000301
10011000110000000300000001
10010030010000000000000001
10311000110030000111000001
10001000130000000000000001
10000000000000000030000001
10000300000000000000000001
10000000000000000000003001
10030100000011001100000001
10100100100011001100111101
10110201100000330000000001
10011011000011001100100101
10000000000011001100030001
10001110030000000000111101
10000000000000000000000001
11111111111111111111111111