11111111111111111111111111
10030000000000000000003001
10000010000000000001110001
10001110000000010000100001
10000010000010011110000001
10000000000010000000000001
10011100300010110111100001
10000111000010110000000001
10000000000000000001100001
10000111100000000001100001
10030000000000000000000001
10000010000001000000111101
10000011100001000000000001
10011000000001000030000001
10001000000001000000110001
10001000000000000000110001
10000000000020000000000001
11111111111111111111111111