11111111111111111111111111
10000000000000000000000001
10001030100000001111100001
10011000110000001030100001
10030030030000001000100001
10311000113000001030100001
10001030100000001101100001
10000000000000000000000001
10000030000000000030000001
10000000000000000000003001
10111111100011001100000001
10103130100010000100111101
10110001100000300000311301
10011011000010000100111101
10001010000011001100311301
10001010030000000000111101
12000000000000000000000001
11111111111111111111111111