11111111111111111111111111
10030000000000000000003001
10000010000000011011000001
10111111111000010301000001
10011111110000011011000001
10301111100000010301000001
10000111300000011011000001
10000010000000010301000001
10000010000030011011000001
10000000000000000000003001
10030000000000000000000001
10000000000011011000111101
10131010000010301000000001
10101010000011011030100101
10000000000000000000130101
10001000030000000000111101
10000000000000000000000021
11111111111111111111111111