11111111111111111111111111
10030000000000000000003001
10000010000000011111000001
10001111100000013031000001
10001111100000011011000001
10000010000000013031000001
10000010300000011011000001
10000010000000000000000001
10000010000030010001000001
10000000000000011111003001
10030000000000000000000001
10000010000001000000111101
10000011100001000000000001
10011000000001000030000001
10001000000001000000011001
10001000030000000000011001
10000000000000000000000021
11111111111111111111111111